#######
#     #
#  @  #
#     #
#$ !# #
#     #
#$ @  #
#     #
#######