#######
#     #
#  @  #
#  @  #
#$$!###
#     #
#$ @  #
#     #
#######