 #####
## $ #####
#  $   $ #
#  @     #
#     ####
#  !  #
#  @  #
#  @  #
#     #
#######