#######
#     #
#  @  #
#     #
#$ !  #
#     #
#  @  #
#$    #
#######