##########
#        #
#   @    #
#   ##   #
#   $!   #
#    $   #
#   ##   #
#    @   #
#        #
##########